...........#........
.#.#.#.#...#........
.#.#.#.#####........
.#.#.#.#............
.#######........#.#.
.#.#.#.#........#.#.
.#.#.#.#........#.#.
.#.#.#.#........#.#.
.#.#.#.#........#.#.
.#.#.#.#........#.#.
.#.#.#.#........#.#.
.#.#.#.#........#.#.
.#.#.#.#........#.#.
.#.#.#.#........#.#.
.#.#.############.#.
.#.#..............#.
.#.################.
.#..................
.#..................
.#..................
\robot 0 17
\robot 0 16
\robot 0 15
